r
finish 
ni
ni
ni
ni
ni
ni
finish 
finish 
i b
finish 
ni
finish 
ni
finish 
ni
finish 
ni
finish 
c
r
c
r
finish 
ni
finish 
ni
ni
finish 
ni
si
ni
ni
ni
x/5i 0x000000000040061A
x/5i 0x000000000040061B
x/5i 0x000000000040061C
x/5i 0x000000000040061D
x/5i 0x000000000040061E
x/5i 0x000000000040061F
x/5i 0x0000000000400620
x/5i 0x0000000000400621
x/5i 0x0000000000400622
x/5i 0x0000000000400623
x/5i 0x0000000000400624
